0 0 0 0 0 0 0 0 0 0 0 0 0 0 0 0 0 0 0 0 0 0 0 0 0 9 9 9 9 9 9 9 9 9 9 9 9 9 9 9 9 9 9 9 9 9 9 9 9 9
0 0 0 0 0 0 0 0 0 0 0 0 0 0 0 0 5 0 0 0 0 0 0 0 0 0 9 9 9 9 9 9 9 9 9 9 9 9 9 9 9 9 9 9 9 9 9 9 9 9
0 0 0 3 3 3 3 0 0 1 1 1 1 1 0 0 4 0 0 3 3 3 3 0 0 0 0 0 0 0 0 0 0 0 0 0 0 0 0 0 9 9 9 9 9 9 9 9 9 9  
0 0 3 3 3 3 0 0 0 1 10 10 10 1 0 0 4 4 5 0 3 3 2 2 3 0 9 9 9 9 9 9 9 9 9 9 9 3 3 0 3 3 9 9 9 9 9 9 9 9
0 3 3 3 3 0 0 1 1 1 10 10 10 1 0 0 4 0 0 0 0 2 2 2 3 0 9 9 9 9 9 9 9 9 9 9 3 3 3 0 3 3 3 9 9 9 9 9 9 9
3 3 3 3 0 0 0 1 10 10 10 10 10 1 0 0 4 0 2 2 2 2 2 2 3 0 9 9 9 9 9 9 9 9 9 3 3 3 3 0 3 3 3 3 9 9 9 9 9 9
3 3 0 0 0 0 0 1 10 1 1 1 1 1 0 0 4 0 2 2 2 2 2 2 3 0 9 9 9 9 9 9 9 9 3 3 3 3 3 0 3 3 3 3 3 9 9 9 9 9
3 3 0 0 5 0 0 6 4 0 0 0 0 0 0 0 4 0 1 1 1 1 1 2 3 0 9 9 9 9 9 9 9 3 3 3 3 3 3 0 3 3 3 3 3 3 9 9 9 9
3 3 0 0 4 0 6 6 4 4 4 4 4 4 4 4 4 0 1 10 10 10 1 2 3 0 9 9 9 9 9 9 3 3 3 3 3 3 3 0 3 3 3 3 3 3 3 9 9 9
3 3 5 4 4 4 4 4 4 6 6 0 0 0 0 0 4 0 1 10 10 10 1 2 3 0 9 9 9 9 9 3 3 3 3 3 3 3 9 0 3 3 3 3 3 3 3 3 9 9
3 3 0 0 4 2 2 2 4 6 0 0 0 0 0 0 4 0 1 1 10 1 1 2 3 0 0 0 0 0 0 0 0 0 0 0 0 0 0 0 0 0 0 0 0 0 0 0 0 9
3 3 0 0 4 2 2 2 4 0 1 1 1 1 1 0 4 0 0 0 4 0 0 2 3 0 9 9 9 9 9 6 6 6 6 6 6 6 6 0 6 6 6 6 6 6 6 6 9 9
3 3 5 4 4 2 2 2 4 0 1 10 10 10 1 0 4 4 4 4 4 0 0 2 3 0 9 9 9 9 9 9 6 6 6 6 6 6 6 0 6 6 6 6 6 6 6 9 9 9
3 3 0 0 4 2 2 2 4 4 10 10 10 10 10 4 4 0 0 0 4 0 0 2 3 0 9 9 9 9 9 9 9 6 6 6 6 6 6 0 6 6 6 6 6 6 9 9 9 9
3 3 0 0 4 2 2 2 4 0 1 10 10 10 1 0 4 0 1 1 10 1 1 2 3 0 9 9 9 9 9 9 9 9 6 6 6 6 6 0 6 6 6 6 6 9 9 9 9 9
3 3 5 4 4 4 4 4 4 0 1 10 10 10 1 0 4 0 1 10 10 10 1 2 3 0 9 9 9 9 9 9 9 9 9 6 6 6 6 0 6 6 6 6 9 9 9 9 9 9
3 3 3 3 4 3 3 6 4 0 1 1 1 1 1 0 4 0 1 10 10 10 1 2 0 0 9 9 9 9 9 9 9 9 9 9 6 6 6 0 6 6 6 9 9 9 9 9 9 9
3 3 3 3 5 3 6 6 4 0 0 0 0 0 0 0 4 0 1 1 1 1 1 2 0 0 9 9 9 9 9 9 9 9 9 9 9 6 6 0 6 6 9 9 9 9 9 9 9 9
3 3 3 3 3 6 6 6 4 4 5 0 5 0 5 4 4 0 2 2 2 2 2 2 3 0 9 9 9 9 9 9 9 9 9 9 9 9 9 0 9 9 9 9 9 9 9 9 9 9
3 3 3 1 1 1 1 1 1 0 0 0 4 0 0 0 4 0 2 2 2 2 2 2 3 0 9 9 9 9 9 9 9 9 9 9 9 9 9 0 9 9 9 9 9 9 9 9 9 9
0 3 3 1 10 10 10 10 10 4 4 4 4 4 4 4 4 0 0 0 0 2 2 2 3 0 9 9 9 9 9 9 9 9 9 2 2 2 2 7 9 9 9 9 9 9 9 9 9 9
0 0 3 1 10 10 10 10 1 0 0 0 0 4 0 0 0 0 0 0 0 0 2 2 3 0 9 9 9 9 9 9 9 9 9 2 2 2 2 7 9 9 9 9 9 9 9 9 9 9
0 0 0 1 10 10 10 10 1 0 0 2 2 7 2 2 0 0 0 0 0 0 0 0 0 0 9 9 9 9 9 9 9 9 9 2 2 2 2 7 9 9 9 9 9 9 9 9 9 9
0 0 0 1 1 1 1 1 1 0 0 0 2 7 2 2 2 2 2 2 2 2 2 0 0 0 0 2 2 2 2 2 2 2 2 2 2 2 2 7 2 2 2 2 2 9 9 9 9 9
0 0 0 0 0 0 0 0 0 0 2 2 2 7 2 2 2 2 2 2 2 2 2 2 2 2 2 2 2 2 2 2 2 2 2 2 2 2 2 7 2 2 2 2 2 2 9 9 9 9
0 0 0 0 0 0 0 0 0 0 2 2 2 7 7 7 7 7 7 7 7 7 7 7 7 7 7 7 7 7 7 7 7 7 7 7 7 7 7 7 2 2 2 2 2 2 2 9 9 9
0 0 0 0 0 0 0 0 0 0 2 2 2 7 2 2 2 2 2 2 2 2 2 2 2 2 2 2 2 2 2 2 2 2 2 2 2 2 2 7 2 2 2 2 2 2 9 9 9 9
0 0 0 0 0 0 0 0 0 0 0 2 2 7 2 2 2 2 2 2 2 2 2 0 0 0 0 2 2 2 2 2 2 2 2 2 2 2 2 7 2 2 2 2 2 9 9 9 9 9
0 0 3 3 0 0 0 0 0 0 6 6 6 4 6 6 6 0 0 0 0 0 0 0 0 0 0 0 0 0 0 9 3 9 3 9 3 9 3 0 9 3 9 3 9 3 9 3 9 3
0 3 3 3 0 0 0 0 0 0 6 6 6 4 6 6 6 0 0 0 0 0 0 0 0 0 0 0 0 0 0 3 9 3 9 3 9 3 9 0 3 9 3 9 3 9 3 9 3 9
3 3 3 0 0 0 0 0 0 0 6 6 6 4 6 6 6 0 0 0 0 0 0 0 0 0 0 0 0 0 0 9 3 9 3 9 3 0 0 0 0 0 0 0 0 2 2 2 2 2
3 3 0 0 0 0 0 0 0 0 6 6 6 4 6 6 6 0 0 0 0 0 0 0 0 0 0 0 0 0 0 3 9 3 9 3 0 0 0 0 0 0 9 0 2 2 2 2 2 2 
3 3 8 8 8 8 8 8 8 8 6 6 6 4 6 6 6 0 0 0 0 0 0 0 0 0 0 0 0 0 3 9 3 9 3 0 0 0 0 0 0 9 2 2 2 2 2 2 2 2
3 3 8 10 10 10 10 10 10 8 6 6 6 4 4 5 6 0 0 0 0 0 0 0 0 0 0 0 0 3 9 3 9 3 0 0 0 9 0 0 0 0 2 2 2 2 2 2 2 2
3 3 8 10 10 10 10 10 10 8 6 6 6 4 6 6 6 0 0 0 0 0 0 0 0 0 0 0 3 9 3 9 3 0 0 0 0 0 0 0 0 2 2 2 2 2 2 2 2 2
3 3 8 10 10 10 10 10 10 10 4 4 4 4 4 5 6 0 0 0 0 0 0 0 0 0 0 3 9 3 9 3 0 0 0 0 0 0 9 0 2 2 2 2 2 2 2 2 2 2
3 3 8 10 10 10 10 10 10 8 2 2 2 4 6 6 6 0 0 0 0 0 0 0 0 0 3 9 3 9 3 0 0 0 0 0 9 0 0 2 2 2 2 2 2 2 2 2 2 2 
3 3 8 10 10 10 10 10 10 8 2 2 2 4 4 5 6 0 0 0 0 0 0 0 0 3 9 3 9 3 0 0 0 0 0 0 0 0 2 2 2 2 2 2 2 2 2 2 2 2  
3 3 8 8 8 8 8 8 8 8 2 2 2 4 6 6 6 0 0 0 0 0 0 0 2 2 2 2 2 2 7 0 0 0 0 9 0 2 2 2 2 2 2 2 2 2 2 2 2 2  
3 3 8 10 10 10 10 10 10 8 2 2 2 4 4 5 6 0 0 0 2 2 2 2 2 2 2 2 2 2 7 0 0 0 0 0 2 2 2 2 2 2 2 2 2 2 2 2 2 2 
3 3 8 10 10 10 10 10 10 8 2 2 2 4 6 6 6 0 0 0 2 2 2 2 2 2 2 2 2 2 7 0 9 0 0 2 2 2 2 2 2 2 2 2 2 2 2 2 2 2 
3 3 8 10 10 10 10 10 10 10 4 4 4 4 4 4 4 4 4 4 7 7 7 7 7 7 7 7 7 7 7 0 0 0 2 2 2 2 2 2 2 2 2 2 2 2 2 2 2 2 
3 3 8 10 10 10 10 10 10 8 6 6 6 4 6 6 6 6 6 4 2 2 2 2 2 2 2 2 0 0 0 0 0 2 2 2 2 2 2 2 2 2 2 2 2 2 2 2 2 2 
3 3 8 10 10 10 10 10 10 8 6 6 6 4 6 6 6 6 6 4 2 2 2 2 2 2 2 0 0 0 0 0 2 2 2 2 2 2 2 2 2 2 2 2 2 2 2 2 2 2
3 3 8 8 8 8 8 8 8 8 8 8 8 10 8 8 8 8 8 10 8 8 8 0 0 0 0 0 0 0 2 2 2 2 2 2 2 2 2 2 2 2 2 2 2 2 2 2 2 2
0 3 3 3 3 3 3 8 10 10 10 10 10 10 10 8 10 10 10 10 10 10 8 0 0 0 0 0 0 9 2 2 2 2 2 2 2 2 2 2 2 2 2 2 2 2 2 2 2 2
0 0 3 3 3 3 3 8 10 10 10 10 10 10 10 8 10 10 10 10 10 10 8 0 0 0 0 0 0 0 2 2 2 2 2 2 2 2 2 2 2 2 2 2 2 2 2 2 2 2
0 0 0 3 3 3 3 8 8 8 8 8 8 8 8 8 8 8 8 8 8 8 8 0 0 0 0 9 9 2 2 2 2 2 2 2 2 2 2 2 2 2 2 2 2 2 2 2 2 2 
0 0 0 0 0 0 0 0 0 0 0 0 0 0 0 0 0 0 0 0 0 0 0 0 0 0 9 9 2 2 2 2 2 2 2 2 2 2 2 2 2 2 2 2 2 2 2 2 2 2
0 0 0 0 0 0 0 0 0 0 0 0 0 0 0 0 0 0 0 0 0 0 0 0 0 9 9 2 2 2 2 2 2 2 2 2 2 2 2 2 2 2 2 2 2 2 2 2 2 2